16 15
################
#1             #
#  ###    #### #
#              #
#   #######    #
#              #
#              #
#  ##  ##  ##  #
#              #
#              #
#    #######   #
#              #
# ####    ###  #
#             2#
################
