16 16
################
#1             #
#              #
#  #  #  #  #  #
#              #
#              #
#  #  #  #  #  #
#              #
#              #
#  #  #  #  #  #
#              #
#              #
#  #  #  #  #  #
#              #
#             2#
################
