16 16
################
#             2#
#              #
# ##############
#              #
#              #
#              #
#              #
#              #
#              #
#              #
#              #
############## #
#              #
#1             #
################
